B.Arch. - Bachelor of Architecture
BCA - Bachelor of Computer Applications
B.E. - Bachelor of Engineering
B.Plan - Bachelor of Planning
B.Sc. IT/CS - Bachelor of Science in IT/Computer Science
B.S. Eng. - Bachelor of Science in Engineering
B.Tech. - Bachelor of Technology

M.Arch. - Master of Architecture
MCA - Master of Computer Applications
M.E. - Master of Engineering
M.Sc. IT/CS - Master of Science in IT/Computer Science
M.S. Eng. - Master of Science in Engineering
M.Tech. - Master of Technology
PGDCA - Post Graduate Diploma in Computer Applications

B.A. - Bachelor of Arts
B.Com. - Bachelor of Commerce
B.Ed. - Bachelor of Education
BFA - Bachelor of Fine Arts
BFT - Bachelor of Fashion Technology
BLIS - Bachelor of Library and Information Science
B.M.M. - Bachelor of Mass Media
B.Sc. - Bachelor of Science
B.S.W. - Bachelor of Social Work
B.Phil. - Bachelor of Philosophy

M.A. - Master of Arts
M.Com. - Master of Commerce
M.Ed. - Master of Education
MFA - Master of Fine Arts
MLIS - Master of Library and Information Science
M.Sc. - Master of Science
M.S.W. - Master of Social Work
M.Phil. - Master of Philosophy

BBA - Bachelor of Business Administration
BFM - Bachelor of Financial Management
BHM - Bachelor of Hotel Management
BHA - Bachelor of Hospital Administration


MBA - Master of Business Administration
MFM - Master of Financial Management
MHM - Master of Hotel Management
MHRM - Master of Human Resource Management
PGDM - Post Graduate Diploma in Management
MHA - Master of Hospital Administration


BAMS - Bachelor of Ayurvedic Medicine and Surgery
BDS - Bachelor of Dental Surgery
BHMS - Bachelor of Homeopathic Medicine and Surgery
BSMS - Bachelor of Siddha Medicine and Surgery
BUMS - Bachelor of Unani Medicine and Surgery
BVSc - Bachelor of Veterinary Science
MBBS - Bachelor of Medicine, Bachelor of Surgery


MDS - Master of Dental Surgery
Doctor of Medicine / Master of Surgery
MVSc - Master of Veterinary Science
MCh - Master of Chirurgiae
DNB - Diplomate of National Board


BPharm - Bachelor of Pharmacy
BPT - Bachelor of Physiotherapy
B.Sc. Nursing - Bachelor of Science in Nursing


MPharm - Master of Pharmacy
MPT - Master of Physiotherapy


BGL - Bachelor of General Laws
BL - Bachelor of Laws
LLB - Bachelor of Legislative Law


LLM - Master of Laws
ML - Master of Legal Studies


CA - Chartered Accountant
CFA - Chartered Financial Analyst
CS - Company Secretary
ICWA - Cost and Works Accountant


IAS - Indian Administrative Service
IPS - Indian Police Service
IRS - Indian Revenue Service
IES - Indian Engineering Services
IFS - Indian Foreign Service


Ph.D. - Doctor of Philosophy
DM - Doctor of Medicine
Postdoctoral Fellow
FNB - Fellow of National Board


Diploma
Polytechnic

others
